BBBBBBBBBBBBBBBBBBBBBBBBBBBBBB
B                            B
B          J                 B
BXXXX XXXXXXXXXXXXXXXXXXXXXXXB
BXXXX XXXXXXXXXXXXXXXXXXXXXXXB
BXXXX    XXXXXXXXXXXXXXXXSSXXB
BXXSSSXXXXXXXSSSXXXXXXXXXSSXXB
BXXSSXXXXXXXXSGXXXXXXXXXXXXXXB
BXXXXXXXXXXXXXCCXXXXXXXX XXXXB
BXXXXXXXXXXXXXXXXXXXXXXX XXXXB
BXXXXXXXXX   GXXXXXXXXXX XXXXB
BXXXXXXXXXC  GXXXXCXXXG    GXB
BXXXXGSCXXXXXXXXXXXXXXXXSXXXXB
BXXSGCUXXXXXX     XXXXXXSXXXXB
BXXXXXXXXXXXXXGG  XXXXXXSXXGXB
BXXXXXXGGXXXXXXTTGUXXXXXXXXTXB
BXGCCCXXXXXXXXXXXXXXXXXUXXXUXB
BXXXTTXXXXXXXXXXXXXXXXXCSGXXXB
BXXXXXXXXXXXXXXXXXXXXXXXTTXXXB
BBBBBBBBBBBBBBBBBBBBBBBBBBBBBB